EA ./Textures/wood.xpm
NO	./Textures/grass.xpm
SO	./Textures/stone.xpm
WE	./Textures/metal.xpm


C 42,44,7

F 255,255,255

11111
11001
11111
11111111111111111111
1000000000000000000111
1111000000000000001 
10000W000000000000111
10000000001110000011
10000000001 10000011
10000000001110000011
10000000000000000011
11111000011111110011
11 11111111   11111
