EA	./Textures/wood.xpm

NO	./Textures/grass.xpm

SO	./Textures/stone.xpm






C 0,0,0

F 255,255,255

WE	./Textures/metal.xpm

1111111111111
1000000000001
1000000000001
10000W0000001
1000000000001
1111111111111
1111111111111
