EA	./Textures/wood.xpm

NO	./Textures/grass.xpm

SO	./Textures/stone.xpm






C 0,0,0

F 255,255,255

WE	./Textures/metal.xpm

1111111111111
1000000000001
1010011100001
10100W0001001
1000011110001
1010000011001
1000000000001
1100011110001
1000000000001
1011000010011
1000011110001
1111111111111
1111111111111
