
EA	./Textures/wood.xpm

NO	./Textures/grass.xpm

SO	./Textures/stone.xpm

WE	./Textures/metal.xpm




R 3000 8000

C 0,0,0

F 255,255,255

S	./Textures/brick.xpm

11111111111111111111
1000000000000000111
1111000000000000011
10000000000000000011
10000000000000000011
10000000000000000011
10000000000000000011
10000000000000000011
1N001000011111110011
1111111111111111111
