NO ./content/textures/barrel.xpm
SO ./content/textures/bluestone.xpm
WE ./content/textures/redbrick.xpm
EA ./content/textures/door.xpm
F 75,74,74
C 1,10,254

1111111111111111111111111
1000000000110000000000001
1011000001110000000000001
1001000000000000000000001
111111111011000001110001
100000000011000001110111111111111
11110111111111011100000010001
11110111111111011111111110001
110000001101010111000000100E1
10000000000000001100000000001
10000000000000001101010010001
1100000111010101111101111000111
11110111 1110101 101111010001
11111111 1111111 11111111111
